1111
1N01
1101
1101
1001
1011
1011
1001
1111
