NO ./assets/N.png
SO ./assets/S.png
WE ./assets/W.png
EA ./assets/E.png


F 255,000,0
C 0000000,0,255

111111111111111111
1000000N0000011
111111111111111111