NO ./assets/N.png
SO ./assets/S.png
WE ./assets/W.png
EA ./assets/E.png

F 255,000,0
C 255,000,0

11111111111111111111111
1000000N000000000000001
11111111111111111111111