NO ./assets/N.png
SO ./assets/S.png
WE ./assets/W.png
EA ./assets/E.png

F 220,100,0
C 225,30,0










                                1
        11111111111111111111111101
        1000000000110000000000001
        1011000001110000000000001
        1001000000000000000000001
111111111011000001110000000000001
100000000011000001110111111111111
11110111111111111100000010001
111101111111111 11101010010001
11000000110101111100000010001
100000000000000011000N0010001
10000000000000001101010010001
110000011101010111110111100111
11110111 1110101 101111010001 1
11111111 1111111 111111111111













